about=关于
actualSize=实际尺寸
add=添加
addLayer=添加图层
addProperty=添加属性
addToExistingDrawing=添加至当前绘图
addWaypoint=添加航点
advanced=高级
align=对齐
alignment=对齐
allChangesLost=警告：所有修改将会丢失！
angle=角度
arc=圆弧
alreadyConnected=节点已连接
apply=应用
arrange=调整图形
arrow=箭头
arrows=箭头
automatic=自动
autosave=自动保存
autosize=自动调整
back=后退
background=背景
backgroundColor=背景色
backgroundImage=背景图片
basic=基本
block=区块
blockquote=区块引用
bold=粗体
border=边框
borderColor=边框颜色
borderWidth=边框宽度
bottom=下
bottomAlign=向下对齐
bottomLeft=左下
bottomRight=右下
bulletedList=项目符号列表
cancel=取消
center=水平居中
cannotOpenFile=无法打开文件
change=更改
changeOrientation=改变方向
circle=圆形
classic=经典
clearDefaultStyle=清除默认风格
clearWaypoints=清除航点
clipart=剪贴画
close=关闭
collapse=折叠
collapseExpand=折叠/展开
collapse-expand=点击折叠/展开\
按住 Shift 键并单击以移动周围图形 \
按住 Alt 键并单击以维持组合尺寸
collapsible=可折叠
comic=手绘
connect=连接
connection=连接
connectionArrows=连接箭头
connectionPoints=连接点
constrainProportions=限制比例
containsValidationErrors=包含验证错误
copy=复制
copyConnect=连接时复制
copySize=复制大小
create=创建
curved=曲线
custom=自定义
cut=剪切
dashed=虚线
default=默认值
delete=删除
deleteColumn=删除列
deleteRow=删除行
diagram=绘图
diamond=方块
diamondThin=方块（细）
direction=方向
distribute=等距分布
done=完成
dotted=点线
doubleClickOrientation=双击以改变方向
dpi=DPI
drawing=绘图 {1}
drawingEmpty=绘图空白
drawingTooLarge=绘图过大
duplicate=创建副本
duplicateIt=复制 {1}
divider=分隔线
east=向右
edit=编辑
editData=编辑数据
editDiagram=编辑绘图
editImage=编辑图片
editLink=编辑链接
editStyle=编辑样式
editTooltip=编辑提示
glass=玻璃
enterGroup=进入组合编辑
enterName=输入名称
enterPropertyName=输入属性名
enterValue=输入值
entityRelation=实体关系
error=出错
errorSavingFile=文件保存出错
exitGroup=退出组合编辑
expand=展开
export=导出
extras=其它
file=文件
filename=文件名
fileNotFound=未找到文件
fill=填充
fillColor=填充色
fitPage=整页显示
fitPageWidth=适应页面宽度
fitTwoPages=双页
fitWindow=适应窗口大小
flip=翻转
flipH=水平翻转
flipV=垂直翻转
font=字体
fontColor=字体颜色
fontFamily=字体
fontSize=字体大小
format=格式
formatPanel=格式面板
formatted=格式化
formattedText=格式化文本
formatPng=PNG
formatGif=GIF
formatJpg=JPEG
formatPdf=PDF
formatSvg=SVG
formatXml=XML
gap=间隙
general=通用
global=全局
gradient=渐变
gradientColor=颜色
grid=网格
gridSize=网格大小
group=组合
guides=参考线
heading=标题
height=高
help=帮助
hide=隐藏
hideIt=隐藏 {1}
hidden=已隐藏
home=首页
horizontal=水平
horizontalFlow=水平流
horizontalTree=水平树
html=HTML
id=ID
image=图片
images=图片
import=导入
increaseIndent=增加缩进
decreaseIndent=减少缩进
insert=插入
insertColumnBefore=向左插入列
insertColumnAfter=向右插入列
insertImage=插入图片
insertHorizontalRule=插入水平标尺
insertLink=插入链接
insertRowBefore=向上插入行
insertRowAfter=向下插入行
invalidInput=无效输入
invalidName=无效名称
invalidOrMissingFile=无效或丢失的文件
isometric=等尺寸
italic=斜体
layers=图层
landscape=横向
lineJumps=跨线
laneColor=泳道颜色
layout=布局
left=左
leftAlign=左对齐
leftToRight=右对齐
line=线条
lineend=线末端
lineheight=行高
linestart=线始端
linewidth=线宽
link=连接
loading=加载中
lockUnlock=锁定/解锁
manual=手册
middle=垂直居中
misc=杂项
more=更多
moreResults=更多结果
move=移动
moveSelectionTo=将所选对象移至 {1}
navigation=导航
new=新建
noColor=无颜色
noFiles=无文件
noMoreResults=无其他结果
none=无
noResultsFor=未找到 '{1}' 的相关结果
normal=正常
north=向上
numberedList=编号列表
ok=确定
opacity=不透明度
open=打开
openArrow=箭头（开）
openFile=打开文件
openLink=打开链接
openInNewWindow=在新窗口打开
openInThisWindow=在当前窗口打开
openSupported=支持从本软件保存的 .xml、.vsdx、.gliffy 格式的文件
options=选项
organic=力导向布局
orthogonal=正交
outline=缩略图
oval=椭圆形
pages=页面
pageView=页面视图
pageSetup=页面设置
pageScale=页面比例
panTooltip=按住空格键并拖拽以移动画布
paperSize=页面尺寸
pattern=样式
paste=粘贴
pasteHere=在这粘贴
pasteSize=粘贴大小
perimeter=周长
placeholders=占位符
plusTooltip=单击进行连接与复制（按住 Ctrl 键并单击以复制，按住 Shift 键并单击以连接）。拖拽进行连接（按住 Ctrl 并拖拽以复制）。
portrait=竖向
position=位置
posterPrint=海报样式
preview=预览
print=打印
radialTree=径向树
redo=恢复
removeFormat=清除格式
removeFromGroup=移出组合
removeIt=删除 {1}
removeWaypoint=删除航点
rename=重命名
renameIt=重命名 {1}
replace=替换
replaceIt={1} 已经存在了，确定要替换它吗？
replaceExistingDrawing=替换当前绘图
reset=重置
resetView=重置视图
reverse=翻转
right=右
rightAlign=右对齐
rightToLeft=从右至左
rotate=旋转
rotateTooltip=单击拖拽以旋转图形，或点击选择旋转 90 度
rotation=旋转
rounded=圆角
save=保存
saveAs=另存为
saved=已保存
scrollbars=滚动条
search=搜索
searchShapes=搜索图形
selectAll=全选
selectEdges=选择边线
selectFont=选择字体
selectNone=取消全选
selectVertices=选择顶点
setAsDefaultStyle=设置为默认样式
shadow=阴影
shape=形状
sharp=锐利
sidebarTooltip=点击展开图形列表，将图形拖拽至画布中，即可开始绘图。按住 Shift 键并单击，以改变所选内容。按住 Alt 键并单击，以插入及连接。
simple=简单
simpleArrow=简单箭头
size=大小
solid=实线
sourceSpacing=源距
south=向下
spacing=间距
straight=直线
strikethrough=删除线
strokeColor=线条颜色
style=样式
subscript=下标
superscript=上标
table=表格
targetSpacing=目标间距
text=文本
textAlignment=文本对齐
textOpacity=字体不透明度
toBack=置于底层
toFront=置于顶层
tooltips=提示
top=上
topAlign=向上对齐
topLeft=左上
topRight=右上
transparent=透明
turn=旋转 90°
uml=UML
underline=下划线
undo=撤销
ungroup=取消组合
untitledLayer=未命名图层
updatingDocument=文件更新中，请稍候...
updatingSelection=选择更新中，请稍候...
url=URL
vertical=垂直
verticalFlow=垂直流
verticalTree=垂直树
view=查看
waypoints=航点
west=向左
width=宽
wordWrap=自动换行
writingDirection=书写方向
zoom=缩放
zoomIn=放大
zoomOut=缩小
basic=基本
Flowchart=流程图

Rectangle=矩形
RoundedRectangle=圆角矩形
Text=文本
Textbox=文本框
Ellipse=椭圆形
Square=正方形
Circle=圆形
Process=流程
Diamond=菱形
Parallelogram=平行四边形
Hexagon=六边形
Triangle=三角形
Cylinder=圆柱
Cloud=云
Document=文件
InternalStorage=内部存储
Cube=立方体
Step=步骤
Trapezoid=梯形
Tape=条带
Note=便签
Card=卡片
Callout=标注
Actor=角色
Or=或
And=与
DataStorage=数据存储
Curve=曲线
BidirectionalArrow=双向箭头
Arrow=箭头
Link=链接
DashedLine=虚线
Line=直线
BidirectionalConnector=双向连接线
DirectionalConnector=定向连接线
Title=标题
UnorderedList=无序列表
OrderedList=有序列表
Table1=表格 1
Table2=表格 2
TablewithTitle1=标题表格 1
TablewithTitle2=标题表格 2
Cross-FunctionalFlowchart=跨功能流程图
HTMLTable1=HTML 表格 1
HTMLTable2=HTML 表格 2
HTMLTable3=HTML 表格 3
HTMLTable4=HTML 表格 4
DoubleRectangle=双矩形
DoubleRoundedRectangle=双圆角矩形
DoubleEllipse=双椭圆形
DoubleSquare=双正方形
DoubleCircle=双圆形
ComicArrow=趣味箭头
ComicRectangle=趣味矩形
ComicDiamond=趣味菱形
IsometricSquare=等轴矩形
IsometricCube=立方体
IsometricEdge1=折线 1
IsometricEdge2=折线 2
CurlyBracket=大括号
HorizontalLine=水平线
VerticalLine=垂直线
HorizontalBackbone=水平分隔符
VerticalBackbone=垂直分隔符
Crossbar=横线
Image(FixedAspect)=图像（固定比例）
Image(VariableAspect)=图像（非固定比例）
Icon=图标
Label1=标签 1
Label2=标签 2
ShapeGroup=形状组合
PartialRectangle=部分矩形
PartialRectangle=部分矩形
ManualLine=手动线
FilledEdge=填充边
HorizontalElbow=圆角水平箭头
VerticalElbow=圆角垂直箭头
TapeData=顺序访问存储器
ManualInput=手动输入
LoopLimit=循环限值
OffPageConnector=跨页引用
Delay=延迟
Display=显示
ArrowLeft=左箭头
ArrowRight=右箭头
ArrowUp=上箭头
ArrowDown=下箭头
DoubleArrow=左右箭头
DoubleArrowVertical=上下箭头
User=用户
Cross=十字形
Corner=边角
Tee=T 形
DataStore=数据存储
Or=或者
Sum=总和
Ellipsewithhorizontaldivider=水平分割椭圆
Ellipsewithverticaldivider=垂直分割椭圆
Sort=排序
Collate=整理
Switch=转换
ProcessBar=流程条
Container=容器
List=列表
ListItem=列表
PartialRectangle=部分矩形
PartialRectangle=部分矩形
PartialRectangle=部分矩形
PartialRectangle=部分矩形
4PointStar=四角星
6PointStar=六角星
8PointStar=八角星
Banner=横幅
CloudCallout=云形标注
Cone=椎体
Cross=十字形
Document=文件
Flash=闪电形
HalfCircle=半圆
Heart=心形
LoudCallout=强调标注
Moon=月亮
NoSymbol=禁止符
Octagon=八边形
OrthogonalTriangle=直角三角形
OvalCallout=椭圆形标注
Parallelepiped=平行六面体
Pentagon=五边形
RectangularCallout=矩形标注
RoundedRectangularCallout=圆角矩形标注
Smiley=笑脸
Star=星星
Sun=太阳
Tick=勾号
Trapezoid=梯形
Wave=波形
X=X 形
ArrowDown=下箭头
ArrowLeft=左箭头
ArrowRight=右箭头
ArrowUp=上箭头
BentLeftArrow=转弯左箭头
BentRightArrow=转弯右箭头
BentUpArrow=转弯上箭头
CalloutDoubleArrow=双向箭头标注
CalloutQuadArrow=四向箭头标注
CalloutUpArrow=上箭头标注
ChevronArrow=V 形箭头
CircularArrow=圆形转弯箭头
Jump-inArrow1=跳转箭头 1
Jump-inArrow2=跳转箭头 2
LeftandUpArrow=直角双向箭头
LeftSharpEdgedHeadArrow=左锐边箭头
NotchedSignal-inArrow=信号输入缺口箭头
QuadArrow=四向箭头
RightNotchedArrow=缺口右箭头
SharpEdgedArrow=锐边箭头
Signal-inArrow=信号输入箭头
SlenderLeftArrow=细长左箭头
SlenderTwoWayArrow=细长双向箭头
SlenderWideTailedArrow=凹尾箭头
StripedArrow=条纹箭头
StylisedNotchedArrow=缺口箭头
TriadArrow=三向箭头
TwoWayArrowHorizontal=左右箭头
TwoWayArrowVertical=上下箭头
UTurnArrow=U 形转弯箭头
UTurnDownArrow=U 形转弯下箭头
UTurnLeftArrow=U 形转弯左箭头
UTurnRightArrow=U 形转弯右箭头
UTurnUpArrow=U 形转弯上箭头
Object=对象
Interface=接口
Class=类 1
Class2=类 2
Item1=项目 1
Item2=项目 2
Divider=分隔符
Spacer=空格
Title=标题
Component=组件
ComponentwithAttributes=属性组件
Block=区块
Module=模块
Package=包
Object=对象
Entity=实体
Class3=类 3
Class4=类 4
Class5=类 5
Interface2=接口
Provided/RequiredInterface=提供/规定接口
RequiredInterface=规定接口
LollipopNotation=棒棒糖表示法
BoundaryObject=边界事件
EntityObject=实体
ControlObject=控制
Actor=角色
UseCase=用例
Start=开始
Activity=活动
CompositeState=状态
Condition=条件
Fork/Join=分叉/汇合
End=结束
Lifeline=生命线
ActorLifeline=角色生命线
BoundaryLifeline=边界生命线
EntityLifeline=实体生命线
ControlLifeline=控制生命线
Frame=框架
Destruction=删除
Note=注释
FoundMessage=创建消息
SynchronousInvocation=同步请求
SelfCall=自调
Callback=回调
Activation=激活
FoundMessage1=创建消息 1
FoundMessage2=创建消息 2
Message=消息
Return=返回
Relation1=关系 1
Association1=关联 1
Aggregation1=聚合 1
Composition1=组成 1
Relation2=关系 2
Dependency=依存性
Generalization=扩展
Association2=关联 2
InnerClass=内部类
Terminate=终止
Implementation=实现
Aggregation2=聚合 2
Composition2=组成 2
Association3=关联 3
Process=任务
Transaction=事务
EventSub-Process=子流程事件
CallActivity=激活
Sub-Process=子流程
LoopedSub-Process=循环子流程
ReceiveTask=接收任务
UserTask=用户任务
AttachedTimerEvent1=附加计时器任务 1
AttachedTimerEvent2=附加计时器任务 2
Pool=泳池
Lane=泳道
Conversation=会话
CallConversation=调用会话
Sub-Conversation=子会话
DataObject=数据对象
DataStore=数据存储
Sub-ProcessMarker=子流程标记
LoopMarker=循环标记
ParallelMIMarker=平行 MI 标记
SequentialMIMarker=顺序 MI 标记
AdHocMarker=即席标记
CompensationMarker=补偿标记
SendTask=发送任务
ReceiveTask=接收任务
UserTask=用户任务
ManualTask=手动任务
BusinessRuleTask=商业规则任务
ServiceTask=服务任务
ScriptTask=脚本任务
Annotation=注释
HorizontalPool1=水平泳池 1
HorizontalPool2=水平泳池 2
HorizontalSwimlane=水平泳道
VerticalPool1=垂直泳池 1
VerticalPool2=垂直泳池 2
VerticalSwimlane=垂直泳道
Group=组
SequenceFlow=顺序流
DefaultFlow=默认流
ConditionalFlow=条件流
MessageFlow1=消息流 1
MessageFlow2=消息流 2
Link=链接
Annotation1=注释 1
Annotation2=注释 2
Card=卡
Collate=整理
Data=数据
Database=数据库
Decision=判定
Delay=延期
DirectData=直接数据
Display=展示
Document=文档
ExtractorMeasurement=提取或测量
InternalStorage=内部存储
LoopLimit=循环限值
ManualInput=手动输入
ManualOperation=手动操作
MergeorStorage=合并或存储
Multi-Document=多文档
Off-pageReference=跨页引用
On-pageReference=页面内引用
Or=或
PaperTape=条带
ParallelMode=平行模式
PredefinedProcess=预定义过程
Preparation=准备
Process=流程
SequentialData=队列数据
Sort=分类
Start1=开始事件 1
Start2=开始事件 2
StoredData=存储数据
SummingFunction=求和功能
Terminator=开始/结束
Transfer=传输

